7 10
___________
00000000000
0____0_____
0____0_____
_0__0______
__00_______
___0_______